1111111111111
1XX1000000001
1000011111001
1P0011EC00001
1111111111111