11111111111111111111111111
1P000000000000000000000E11
10111111111111111111110111
10000100010001000010100011
11000100010001000010101011
11000100010001000010101011
11000100010001000010101011
11000100010001000010101011
11011111111111111111111011
1C000000000000000000000C11
11111111111111111111111111