1111111111111
1001000000001
1C00011111001
1P0011EC00001
1111111111111